NO main.c
SO main.c
WE main.c
EA main.c

C 53,10168,130
F 81,41,084

111111111111111111111111 
1
11111111111111111111111 
100000000011000100000001 
1111111111111111111111111 