NO  main.c
SO  main.c
WE  main.c
EA main.c

F 81,41,28
C 53,168,230

1111111111111111111111111111111111
10000000000000100000000000000W000011111
110000110000000001110000000000110010001
111111111111111111111111111111111111111111111111111
