NO  main.c
SO  main.c
WE  main.c
EA main.c

F 81,41,28
C 53,168,230 
 
1111111111111111111111111111111111
100000000000001000000000000000011111
11000011000000000111000000000100010011
11000011000000000111000000000100010001
1100001100000000011100001N000100010001
11000011000000000111000001000100010001
11000011000000000111000000000100010001
11000011000000000111000000000100010001
111111111111111111111111111111111111111111111111111
