NO ./main.c
SO ./main.c
WE ./main.c
EA ./main.c

F 220,100,0
C 225,30,0

1111111111111111
10000S0000000001 
1111111111111111 
